ErrorCodeXMLLabel=ERRORＣＯＤＥ的 那份文件
SourceExcelLabel=比對測試站的 Excel 檔案，例如MB站
SelectSheetLabel=選擇測試站SHEET表：
BrowseButton=瀏覽
CompareButton=比對
SuccessTitle=成功
SuccessMsg=比對完成，結果已儲存於：
CancelTitle=取消
CancelMsg=已取消操作。
FileExistsTitle=檔案已存在
FileExistsMsg=檔案 {output_path} 已存在，是否要覆蓋？
ErrorTitle=錯誤
SheetLoadError=載入工作表時發生錯誤：{error}
CompareError=比對時發生錯誤：{error}
NotFound=查無說明
NotFoundCN=查無中文說明
WindowWidth=950
WindowHeight=350
FontSize=10
BrowseXMLTooltip=選擇Error code Excel檔案
BrowseExcelTooltip=選擇來源Excel檔案
BrowseSheetTooltip=選擇工作表
ShowGuide=1
ShowGuidePictureNumber=5
ShowGuideContent_1=錯誤碼比對工具！本工具可協助您快速比對測試站資料與錯誤碼說明，並自動產生對應說明的新 Excel 檔案。請依照導覽步驟操作。\n步驟一：選擇error code 檔案\n請點選「瀏覽」按鈕（通常為 Test Item Code XXX.xlsx）。
ShowGuideContent_2=選擇待比對的測試站 Excel 檔案\n請點選第二個「瀏覽」按鈕，選擇您要比對的測試站 Excel 檔案（例如 MB 站資料）。\n選擇要比對的工作表\n從下拉選單中選擇來源 Excel 檔案中的工作表，確認後點擊「比對」按鈕開始比對。
ShowGuideContent_3=步驟二：若已經有檔案會跳出警示視窗
ShowGuideContent_4=步驟三：比對完成！\n系統會自動產生新 Excel 檔案，並將比對結果與說明補齊。
ShowGuideContent_5=您也可以在「Test Item All」分頁查看完整備份。檔名會附加上compare_ERROR_CODE.xlsx\n如需再次查看導覽，可於 setup.txt 設定 ShowGuide=1。
LastExcelPath=D:/((Python TOOL/compare_errorcode_ver1/VER3/EXCEL
LastXMLPath=D:/((Python TOOL/compare_errorcode_ver1/VER3/EXCEL
LastOutputDir=D:\((Python TOOL\compare_errorcode_ver1\VER3\EXCEL
